{"label":"1. Classic","gate_score":20,"split_scores":[3,6,15]}

xxxxxxxxxxxxxxxxxxxx
x..................x
x..................x
x..................x
x..................x
x..................x
x..................x
x..................x
x..................x
x..................#
x..................x
x..................x
x..................x
x..................x
x........S.........x
x..................x
x..................x
x..................x
x..................x
xxxxxxxxxxxxxxxxxxxx
