{"label":"2. Wrap Around","gate_score":8,"split_scores":[5]}

xxxxxx........xxxxxx
x..................x
x..................x
x..................x
x..................x
x..................x
....................
..S.................
....................
....................
....................
....................
....................
...............#....
x..................x
x..................x
x..................x
x..................x
x..................x
xxxxxx........xxxxxx
