{"label":"3. Puddle","gate_score":10,"split_scores":[6]}

xxxxxx........xxxxxx
x..................x
x..................x
x..................x
x...1..............x
x..................x
....................
....................
....................
.....S..............
....................
....................
....................
...............#....
x..................x
x..............1...x
x..................x
x..................x
x..................x
xxxxxx........xxxxxx
