{"label":"4. Chaos","gate_score":12,"split_scores":[7,10,11]}

xxxxxxxxxxxxxxxxxxxx
x........x.........x
x........x.........x
x....1...x...2.....x
x........x.........x
x........x.........x
x...2....x.....3...x
x........x.........x
x........x.........x
xxxxxxxxxxxxxxxxxxxx
x........x.........x
x........x.........x
x..1.....x...3.....x
x........x....#....x
x........x.........x
x........x.........x
x.....4..x.....4...x
x........x.S.......x
x........x.........x
xxxxxxxxxxxxxxxxxxxx
