{"label":"4. Chaos","gate_score":12,"split_scores":[7,10,11]}

xxxxx.xx.xxxxxxxxxxx
x.......1..........x
x..................x
x.....xx.......xx..x
x.....xx.......xx..x
x..........2.......x
x..................x
x..................x
x..................x
....................
.........S..........
x..................x
x.......3..........x
x..................x
x..................x
x.....xx.......#x..x
x.....xx...1...xx..x
x..........2.......x
x....3.............x
xxxxx.xx.xxxxxxxxxxx
