{"label":"6. End Game","gate_score":12,"split_scores":[5,10]}

....................
....................
..xx............xx..
..xxxx........xxxx..
....xx........xx....
.........S..........
....................
xxxxxxxxxxxxxxx#xxxx
.........xx.........
.........xx.........
.......xxxxxx.......
......xx....xx......
.....xx......xx.....
.....x........x.....
.....x........x.....
.....x........x.....
.....x........x.....
.....x........x.....
.....x........x.....
.....x........x.....
