{"label":"6. Final Level","gate_score":12,"split_scores":[5,10]}

.........x..........
.........x..........
.........x..........
.........#..........
.........x.....S....
.........x..........
.........x..........
....xxxxxxxxxx......
....x........x......
....x........x......
....x........x......
....x........x......
....x........x......
....x........x......
....x........x......
....x........x......
....x........x......
....x........x......
....x........x......
....x........x......
